destWidth 270
destHeight 406
map_width 20
map_height 20
tile_width 32
tile_height 32
solid_tiles
2, 91, 81, 82, 80, 89, 73, 78, 85, 76, 92
layer1
0, 0, 0, 0, 0, 0, 0, 0, 0, 0, 0, 0, 0, 0, 0, 0, 0, 0, 0, 0
0, 0, 0, 0, 0, 0, 0, 0, 0, 0, 0, 0, 0, 0, 0, 0, 0, 0, 0, 0
3, 3, 35, 35, 35, 35, 35, 35, 35, 0, 3, 35, 35, 35, 35, 35, 35, 35, 35, 0
3, 3, 35, 35, 35, 35, 35, 35, 35, 0, 3, 35, 35, 35, 35, 35, 35, 35, 35, 0
35, 35, 0, 0, 0, 0, 0, 35, 35, 0, 0, 0, 0, 35, 35, 0, 35, 35, 0, 0
35, 35, 0, 3, 3, 3, 0, 35, 35, 0, 35, 35, 35, 35, 35, 0, 35, 35, 0, 0
35, 35, 0, 35, 35, 35, 35, 35, 35, 0, 35, 35, 35, 35, 35, 0, 35, 35, 0, 0
35, 35, 0, 35, 35, 35, 35, 35, 35, 35, 35, 35, 0, 35, 35, 0, 35, 35, 0, 0
35, 35, 0, 0, 0, 0, 0, 35, 35, 35, 35, 35, 0, 35, 35, 0, 35, 35, 0, 0
35, 35, 0, 35, 35, 35, 0, 0, 0, 0, 35, 35, 0, 35, 35, 0, 35, 35, 0, 0
35, 35, 0, 35, 35, 35, 0, 35, 35, 35, 35, 35, 0, 35, 35, 0, 35, 35, 0, 0
35, 35, 0, 35, 35, 35, 0, 35, 35, 35, 35, 35, 0, 35, 35, 0, 35, 35, 0, 0
35, 35, 0, 35, 35, 35, 0, 35, 35, 0, 35, 35, 0, 35, 35, 0, 35, 35, 0, 0
35, 35, 0, 35, 35, 35, 0, 35, 35, 0, 35, 35, 0, 35, 35, 0, 35, 35, 0, 0
35, 35, 0, 35, 35, 35, 0, 35, 35, 0, 35, 35, 0, 35, 35, 0, 35, 35, 0, 0
35, 35, 0, 35, 35, 35, 0, 35, 35, 0, 35, 35, 0, 35, 35, 0, 35, 35, 0, 0
35, 35, 0, 35, 35, 35, 0, 35, 35, 0, 35, 35, 0, 35, 35, 0, 35, 35, 45, 45
35, 35, 35, 35, 35, 35, 35, 35, 35, 0, 35, 35, 0, 35, 35, 35, 35, 35, 45, 45
35, 35, 35, 35, 35, 35, 35, 35, 35, 0, 3, 3, 0, 35, 35, 35, 35, 35, 0, 0
0, 0, 0, 0, 0, 0, 0, 0, 0, 0, 0, 0, 0, 0, 0, 0, 0, 0, 0, 0
layer2
81, 81, 81, 81, 81, 81, 81, 81, 81, 81, 81, 81, 81, 81, 81, 81, 81, 81, 81, 81
81, 81, 81, 81, 81, 81, 81, 81, 81, 81, 81, 81, 81, 81, 81, 81, 81, 81, 81, 81
0, 0, 0, 0, 0, 0, 0, 0, 0, 73, 0, 0, 0, 0, 0, 0, 0, 0, 0, 73
0, 0, 0, 0, 0, 0, 0, 0, 0, 73, 0, 0, 0, 0, 0, 0, 0, 0, 0, 73
0, 0, 92, 81, 81, 81, 80, 0, 0, 73, 82, 82, 85, 0, 0, 78, 0, 0, 92, 73
0, 0, 73, 0, 0, 0, 76, 0, 0, 73, 0, 0, 0, 0, 0, 73, 0, 0, 73, 73
0, 0, 73, 0, 0, 0, 0, 0, 0, 76, 0, 0, 0, 0, 0, 73, 0, 0, 73, 73
0, 0, 73, 0, 0, 0, 0, 0, 0, 0, 0, 0, 78, 0, 0, 73, 0, 0, 73, 73
0, 0, 73, 81, 81, 81, 80, 0, 0, 0, 0, 0, 73, 0, 0, 73, 0, 0, 73, 73
0, 0, 73, 0, 0, 0, 73, 81, 81, 85, 0, 0, 73, 0, 0, 73, 0, 0, 73, 73
0, 0, 73, 0, 0, 0, 73, 0, 0, 0, 0, 0, 73, 0, 0, 73, 0, 0, 73, 73
0, 0, 73, 0, 0, 0, 73, 0, 0, 0, 0, 0, 73, 0, 0, 73, 0, 0, 73, 73
0, 0, 73, 0, 0, 0, 73, 0, 0, 78, 0, 0, 73, 0, 0, 73, 0, 0, 73, 73
0, 0, 73, 0, 0, 0, 73, 0, 0, 73, 0, 0, 73, 0, 0, 73, 0, 0, 73, 73
0, 0, 73, 0, 0, 0, 73, 0, 0, 73, 0, 0, 73, 0, 0, 73, 0, 0, 73, 73
0, 0, 73, 0, 0, 0, 73, 0, 0, 73, 0, 0, 73, 0, 0, 73, 0, 0, 73, 73
0, 0, 76, 0, 0, 0, 76, 0, 0, 73, 0, 0, 73, 0, 0, 73, 0, 0, 0, 0
0, 0, 0, 0, 0, 0, 0, 0, 0, 73, 0, 0, 73, 0, 0, 73, 0, 0, 0, 0
0, 0, 0, 0, 0, 0, 0, 0, 0, 73, 0, 0, 73, 0, 0, 73, 0, 0, 92, 81
82, 82, 82, 82, 82, 82, 82, 82, 82, 82, 82, 82, 82, 82, 82, 82, 82, 82, 82, 82
